11111111111111111111111111111111111111111
1v1v0v0v1v0v0v0v0v0v1v0v0v0v0v0v1v0v0v0v1
10101010101111111110111011111110101110101
1v0v1v1v1v1v0v1v0v1v0v1v0v0v0v1v1v1v0v1v1
11111010101011101011101111111010101011101
1v0v0v1v1v1v0v0v1v0v1v0v0v1v0v1v0v1v1v1v1
10111110101110111011111110111110111010101
1v0v0v1v1v0v1v0v1v0v0v0v1v0v0v1v1v1v1v0v1
10111010101011101111101111111010101011111
1v1v0v1v1v1v1v1v1v0v1v1v0v0v0v1v0v1v0v0v1
10101110111010101010101011111111101111101
1v1v1v1v0v0v1v0v1v1v1v0v1v0v0v0v1v1v1v0v1
10101011111110111110111111101110101010101
1v1v1v0v0v0v1v1v0v0v0v1v0v1v1v0v1v1v1v1v1
10101111101010101111101010101011101010111
1v1v0v0v1v1v0v0v1v0v1v1v1v0v1v0v1v0v1v0v1
10111110111111111011101011111110111111101
1v0v0v1v1v0v1v0v1v0v0v1v1v0v0v0v1v0v1v0v1
11111110101010101011111010111111101010111
1v0v0v0v1v1v0v1v1v0v0v0v1v0v1v0v0v1v1v0v1
10111110101111101111111111101111101011101
1v1v0v1v1v1v0v1v1v0v0v0v1v1v0v1v0v1v0v1v1
10101010101010101011111010111010111110101
1v1v1v1v1v1v1v1v0v1v1v0v1v0v0v0v1v0v1v0v1
10101010101010111110101011111111101111111
1v1v1v1v1v1v1v0v0v0v1v1v1v0v1v0v1v1v0v0v1
10101011101011111110101110101010101110101
1v0v1v1v0v1v0v0v1v0v1v0v1v1v0v1v1v1v0v1v1
10111010111111101011111010111110101011101
1v1v0v1v1v0v0v0v1v0v1v0v1v1v1v0v1v0v1v0v1
11101110101111111111101010101011111110111
1v0v1v0v1v1v0v0v1v0v0v1v1v1v1v0v0v0v1v0v1
10111011101011101011111010101111111011101
1v0v0v1v0v1v1v1v1v0v0v1v1v0v1v0v1v0v0v1v1
10111111101010101111101111101110101111101
1v0v0v0v1v1v1v0v1v0v1v1v0v1v0v0v1v0v0v1v1
11111110101011101010101010111011111110101
1v0v0v1v1v1v0v1v0v1v0v1v1v1v0v1v0v0v0v1v1
10111010101110111111111010101110111111101
1v0v1v0v0v0v1v0v0v0v0v0v1v0v0v1v0v0v0v0v1
11111111111111111111111111111111111111111
